21313131313132
10101010101012
21010101010101
10101010101012
21010101010101
10101010101012
21313131313132