20000011000002
00000011000000
00000011000000
11111122111111
11111122111111
00000011000000
00000011000000
20000011000002